11111111
1P0C00E1
11111111
10001111
111CC111